#####  
#   ###
#@$   #
#     #
#.$ ###  
#  .#  
#####  

  ##### 
###   # 
#.@$  # 
### $.# 
#.# $ # 
# # . ##
#$  $ .#
#  !   #
########

  ####   
###  ####
#     $ #
#    #$ #
#.  .#@ #
#########

